+++++++++++++++++++++++++++++++++++++++++++++++++++++++++++++++++++++++++++++++++
..........+.........+.........+.........+..............+..............+.........+
..........+.........+.........+.........+..............+..............+.........+
..........+.........+.........+.........+..............+..............+.........+
..........+.........+.........+.........+..............+..............+.........+
+....+....++++++....+....+....+....+....+....++++++....+....++++++....++++++....+
+....+.........+.........+....+....+....+....+.........+.........+..............+
+....+.........+.........+....+....+....+....+.........+.........+..............+
+....+.........+.........+....+....+....+....+.........+.........+..............+
+....+.........+.........+....+....+....+....+.........+.........+..............+
+....++++++....+++++++++++....++++++....+....+....++++++....+++++++++++++++++++++
+....+....+..............+....+.........+....+........................+.........+
+....+....+..............+....+.........+....+........................+.........+
+....+....+..............+....+.........+....+........................+.........+
+....+....+..............+....+.........+....+........................+.........+
+....+....+++++++++++....+....+....++++++....+++++++++++....++++++....+....+....+
+.........+....+.........+.........+.........+..............+....+.........+....+
+.........+....+.........+.........+.........+..............+....+.........+....+
+.........+....+.........+.........+.........+..............+....+.........+....+
+.........+....+.........+.........+.........+..............+....+.........+....+
+++++++++++....+....++++++....+++++++++++....+....+++++++++++....+....+++++++++++
+...................+..............+.........+....+...................+.........+
+...................+..............+.........+....+...................+.........+
+...................+..............+.........+....+...................+.........+
+...................+..............+.........+....+...................+.........+
+....++++++++++++++++....+....++++++....++++++....+....++++++++++++++++....+....+
+........................+..............+.........+........................+.....
+........................+..............+.........+........................+.....
+........................+..............+.........+........................+.....
+........................+..............+.........+........................+.....
+++++++++++++++++++++++++++++++++++++++++++++++++++++++++++++++++++++++++++++++++