++++++++++++++++++++++++++++++++++++++++++++++++++++++++++++++++++++++++++++++++
+..................................+++++++++++++...............................+
+.++++++++++++++++++++++++++.+++++.+++++++++++++.+++++++++++++++++++++++++++++.+
+.++++++++++++++++++++++++++.+++++.+++++++++++++.+++++++++++++++++++++++++++++.+
+.++++++++++++++++++++++++++.+++++.+++++++++++++.+++++++++++++++++++++++++++++.+
+.++++++++++++++++++++++++++.+++++.+++++++++++++.+++++++++++++++++++++++++++++.+
+.++++++++++++++++++++++++++.+++++.+++++++++++++.+++++++++++++++++++++++++++++.+
+.++++++++++++++++++++++++++.+++++.+++++++++++++.+++++++++++++++++++++++++++++.+
+.++++++++++++++++++++++++++.+++++.+++++++++++++.+++++++++++++++++++++++++++++.+
+.++++++++++++++++++++++++++.+++++.+++++++++++++.+++++++++++++++++++++++++++++.+
+.++++++++++++++++++++++++++.+++++.+++++++++++++.+++++++++++++++++++++++++++++.+
+.++++++++++++++++++++++++++.......:::::::::::::.+++++++++++++++++++++++++++++.+
+.++++++++++++++++++++++++++:+++++++++++++++++++.+++++++++++++++++++++++++++++.+
+.++++++++++++++++++++++++++:+++++++++++++++++++.+++++++++++++++++++++++++++++.+
+.++++++++++++++++++++++++++:+++++++++++++++++++.+++++++++.....................+
+.++++++++++++++++++++++++++:+++++++++++++++++++.+++++++++.+++++++++++++++++++.+
+............................+++++++++++++++++++.+++++++++.+++++++++++++++++++.+
++++++++++++.+++++++++++++++.+++++++++++++++++++.+++++++++.+++++++++++++++++++.+
++++++++++++.+++++++++++++++.+++++++++++++++++++.+++++++++.+++++++++++++++++++.+
++++++++++++.+++++++++++++++.+++++++++++++++++++.+++++++++.++++++++++.++++++++.+
++++++++++++.+++++++++++++++.+++++++++++++++++++.+++++++++.++++++++++.++++++++.+
++++++++++++.+++++++++++++++.+++++++++++++++++++.+++++++++............++++++++.+
++++++++++++.....................................+++++++++++++++++++++++++++++.+
+++++++++++++++++++++++++++++++++++++.+++++.++++.+++++++++++++++++++++++++++++.+
+++++++++++++++++++++++++++++++++++++.+++++.++++.+++++++++++++++++++++++++++++.+
+++++++++++++++++++++++++++++++++++++.+++++.++++.+++++++++++++++++++++++++++++.+
+++++++++++++++++++++++++++++++++++++.+++++.++++.+++++++++++++++++++++++++++++.+
+++++++++++++++++++++++++++++++++++++..........................................+
++++++++++++++++++++++++++++++++++++++++++++++++++++++++++++++++++++++++++++++++
++++++++++++++++++++++++++++++++++++++++++++++++++++++++++++++++++++++++++++++++
