================================================================================
================================================================================
================================================================================
================================================================================
================================================================================
================================================================================
================================================================================
================================================================================
========################################################################========
========#..............................................................#========
========#.############################################################.#========
========#..==========================================================#..========
========#.#==========================================================#.#========
========#.#==========================================================#.#========
========#.#==========================================================#.#========
========#.#==========================================================#.#========
========#.#==========================================================#.#========
========#.#==========================================================#.#========
========..#==========================================================..#========
========#.############################################################.#========
========#..............................................................#========
========################################################################========
================================================================================
================================================================================
================================================================================
================================================================================
================================================================================
================================================================================
================================================================================
================================================================================