:::::.....=====:::::=====++++++++++:::::=====.....=====+++++=====:::::=====+++++
:::::.....=====:::::=====++++++++++:::::=====.....=====+++++=====:::::=====+++++
:::::.....=====:::::=====++++++++++:::::=====.....=====+++++=====:::::=====+++++
:::::.....=====:::::=====++++++++++:::::=====.....=====+++++=====:::::=====+++++
:::::.....=====:::::=====++++++++++:::::=====.....=====+++++=====:::::=====+++++
..........:::::.....=====::::::::::==========::::::::::+++++=====.....+++++:::::
..........:::::.....=====::::::::::==========::::::::::+++++=====.....+++++:::::
..........:::::.....=====::::::::::==========::::::::::+++++=====.....+++++:::::
..........:::::.....=====::::::::::==========::::::::::+++++=====.....+++++:::::
..........:::::.....=====::::::::::==========::::::::::+++++=====.....+++++:::::
.....+++++...............+++++=====.....+++++:::::+++++++++++++++++++++++++.....
.....+++++...............+++++=====.....+++++:::::+++++++++++++++++++++++++.....
.....+++++...............+++++=====.....+++++:::::+++++++++++++++++++++++++.....
.....+++++...............+++++=====.....+++++:::::+++++++++++++++++++++++++.....
.....+++++...............+++++=====.....+++++:::::+++++++++++++++++++++++++.....
::::::::::=====..........===============:::::.....:::::+++++.....=====:::::=====
::::::::::=====..........===============:::::.....:::::+++++.....=====:::::=====
::::::::::=====..........===============:::::.....:::::+++++.....=====:::::=====
::::::::::=====..........===============:::::.....:::::+++++.....=====:::::=====
::::::::::=====..........===============:::::.....:::::+++++.....=====:::::=====
:::::::::::::::=====.....+++++==========::::::::::=====..........+++++.....=====
:::::::::::::::=====.....+++++==========::::::::::=====..........+++++.....=====
:::::::::::::::=====.....+++++==========::::::::::=====..........+++++.....=====
:::::::::::::::=====.....+++++==========::::::::::=====..........+++++.....=====
:::::::::::::::=====.....+++++==========::::::::::=====..........+++++.....=====
+++++::::::::::++++++++++=====.....:::::.....::::::::::=====..........:::::.....
+++++::::::::::++++++++++=====.....:::::.....::::::::::=====..........:::::.....
+++++::::::::::++++++++++=====.....:::::.....::::::::::=====..........:::::.....
+++++::::::::::++++++++++=====.....:::::.....::::::::::=====..........:::::.....
+++++::::::::::++++++++++=====.....:::::.....::::::::::=====..........:::::.....
