#################################################################################
....#...........#.....#...#...#.....#...#.......#.....#.....#...#.......#.......#
#.#.###.#######.#.###.#.###.#.#.###.#.#.#.#####.#.###.#.#.###.#.#######.#.#####.#
#.#.....#...#.#.#...#.......#...#...#.#...#.....#.#...#.#.....#.#.....#.#...#...#
#.#######.#.#.#.###.#############.###.#####.#####.#.###.#######.#.###.#.###.#.###
#.#...#.#.#...#.....#...........#.#.....#...#...#.#...#.#.#...#...#...#.#...#...#
#.#.#.#.#.###########.#########.#.#.#####.###.#.#.###.#.#.#.#.#####.###.#.#####.#
#.#.#...#.......#.....#...#...#.#.#.#...#.....#...#.#...#...#.....#.#...#.#.....#
#.#####.#####.#.#.#######.#.#.#.#.#.###.#######.###.#############.#.#.###.#######
#.#.......#...#.#.........#.#.....#...#.#.......#.#.......#.....#.....#...#.....#
#.#.#######.###.###########.###.#####.#.#.#####.#.#####.#.#.#.#####.#####.#.#.###
#.#...#.......#.............#...#...#.#...#...#.#...#...#...#.#.....#...#.#.#...#
#.###.#####.#################.###.#.#.#######.#.###.#.#######.#.#####.#.#.###.#.#
#...#.#...#.....#.#...........#...#...#.......#...#.#...#...#...#.....#.#.#...#.#
###.#.#.#.#####.#.#.###########.#######.###########.###.#.#.#####.#####.#.#.#####
#...#.#.#.....#...#...................#...#.......#.#...#.#.#.....#...#.#.#.....#
#.###.#.#####.###############.#######.#.#.#.#####.#.#.###.#.#########.#.#.#####.#
#.#...#.....#.........#.......#.....#...#.#.....#...#.#...#.#...........#.....#.#
#.#.#######.#########.###.#####.###.#.#####.#########.###.#.#.###############.#.#
#.#.......#.....#...#.....#...#...#.#.....#.#.....#...#...#...#.....#.....#.#.#.#
#.#.#####.#####.#.#.###.###.#.###.#.#####.#.#.###.#.###.#######.###.#.###.#.#.#.#
#.#.#...#...#.#...#.#...#...#.#.#.#.#.......#.#...#.#...#.......#.#.#...#...#.#.#
#.###.#.###.#.#####.#.###.###.#.#.#.###########.###.#.###.###.###.#.#####.#.#.#.#
#.#...#.....#.......#.....#...#...#.......#...#.#.#.......#.#.....#.#.....#.#.#.#
#.#.#########.#############.#############.#.#.#.#.###.###.#.#####.#.#.#####.#.#.#
#.#.....#...#...#...........#.............#.#.#.#.....#...#.......#...#...#...#.#
#.#####.#.#####.#.#########.#.#####.###.#####.#.#######.#########.#####.#.#####.#
#...#...#.#.....#.......#.#.#.#.#.....#.......#.......#.......#.#.#.....#.......#
#.#.###.#.#.#######.###.#.#.#.#.#.###.#########.#####.#######.#.#.#.###.#########
#.#.....#...#.......#...#.....#...#.............#.....#.........#.....#..........
#################################################################################