#################################################################################
....#...#.......#...#.....#.....#.#...#.....#...................#.#.....#...#...#
###.#.#.#.#####.#.#.#####.#.###.#.#.#.#.###.#.#################.#.#.###.#.###.#.#
#...#.#.....#...#.#.#.....#.#.#.#...#...#...#.#.....#.#.......#.#.#...#...#...#.#
#.###.#######.###.#.#.#####.#.#.#########.###.#.###.#.#.#####.#.#.###.###.#.#.#.#
#...#...#.........#...#...#...#.#.......#.#...#.#...#...#.......#...#.#.#...#.#.#
###.###.#.###.#####.###.#.#####.#######.#.#.###.#######.#.###.###.#.#.#.#######.#
#...#...#.#...#...#.....#.....#.....#...#.#.#.#.....#...#...#.#...#.#.#.........#
#.#######.#####.#############.###.###.#.#.#.#.###.###.#####.#.#.#####.#####.#.###
#.#...#.....#.#...............#...#...#...#.#...#...#...#...#.........#.....#.#.#
#.#.#.#####.#.###.#############.###.#########.#.###.###.#.#####.#######.#.###.#.#
#...#...#...#...#...#...#...#.#.#.......#.....#...#.....#.#.....#.....#.#.#.....#
#####.#.#.#####.###.#.#.#.#.#.#.#.#.###.#.#######.#.#######.#####.#####.#.#####.#
#.....#...#...#.......#...#.....#.#.#...#...#.....#...#...#.#...#.......#.#.....#
#.#########.#####.#.#############.#.#.#######.#########.#.#.#.#.###.#######.#####
#...#.....#...#...#.........#.....#.#.#...#...#.........#.#.#.#...........#.#...#
###.#.#.#####.#.###########.#.#######.#.#.#.###.#######.#.#.#.###########.#.#.#.#
#.#...#...#.#...#...........#.#.....#.#.#.......#.......#...#...#.......#.#...#.#
#.#######.#.#####.#.#########.#.#.#.###.###.#####.###########.#.#.#####.#.#####.#
#...#...#.#...#...#.....#...#...#.#.....#.#.#...#.........#...#...#...#.#.....#.#
###.#.###.#.#.#########.#.#.#####.#######.#.#.#.#########.#.#######.###.#####.#.#
#.#.....#.#.#.#.......#...#.#.....#.....#.#.#.#...#.......#...#...#.....#.....#.#
#.###.#.#.#.#.#.#####.#.###.#.#####.###.#.#.#.###.#.#######.###.#.#.#####.#####.#
#.....#.#...#...#.....#...#...#...#...#.....#.#.#.....#...#...#.#.#...#...#...#.#
#.#####.#.###.###.#############.#.###.###.###.#.###.#.#.#.###.#.#.#.###.#####.#.#
#.#...#...#...#...#.....#.......#.#...#...#...#.....#...#.#...#.#.#...#.#.#...#.#
#.#.#.#########.#######.#.#######.#.###.###.#############.#####.#####.#.#.#.###.#
#...#.........#.#.....#.#.#.....#...#.....#.#.......#...#...#.#.......#...#.#.#.#
#############.#.#####.#.#.#.#########.#####.#.#####.#.#####.#.###########.#.#.#.#
#.............#.......#...#...........#.....#.....#.........#...............#....
#################################################################################