#################################################################################
....#.............#.......#.....#...#.......#...........#...................#...#
#.#.#.###########.#.#####.#####.#.#.#######.#.#.#######.###.###########.###.#.#.#
#.#...#...#...#...#...#...#...#.#.#.........#.#.#.....#...#.....#.........#...#.#
#.#####.#.###.#.#######.###.#.#.#####.#######.#.###.#.###.#######.###############
#.#...#.#...#.#.............#.......#.#.......#.#...#...#.#...#...#...#.........#
#.#.#.#.###.#.#########.###########.#.#########.#.#####.#.#.#.#.###.#.#.#######.#
#.#.#.#...#.#.#.......#.#...#.#...#.........#...#...#.#...#.#.#.#...#.#...#.....#
#.#.#.#####.#.#.#.#####.#.#.#.#.#.###.###.#.#.#####.#.#####.#.#.#.###.###.###.###
#.#.#.......#.#.#.#...#...#.#...#.#...#...#.#.#.....#.#.....#.#.#.#...#...#...#.#
#.#.#########.#.#.#.#.###.#.#####.#.###.#.###.#.#####.#######.#.#.#.###.###.###.#
#...#.......#...#.#.#.#.#.#.....#.#...#.#.#...#...#...#.......#.#.#.....#...#...#
#####.#.#######.###.#.#.#.#####.#.###.#.#.#.#####.#.###.#.#####.#.###.###.###.#.#
#.....#.............#.....#...#...#.#.#.#.#.#...#...#...#.#.....#.#.#...#...#.#.#
#.#####################.###.#.#####.#.#.###.#.#.#####.###.#.#####.#.#######.#.#.#
#...#...#...#.....#...#.#...#.#...#...#.......#.....#.#...#.....#.#.#.......#.#.#
###.###.#.###.###.###.#.#.###.#.#.#####.###.#######.#.#.#####.#.#.#.#.#######.#.#
#.#.....#...#...#.....#.#.#.#.#.#.......#.....#...#.#.#...#...#...#.....#...#.#.#
#.#########.###.#######.#.#.#.###.###########.#.#.#.#.#.###.###########.###.#.#.#
#...#.....#.#...#.......#.#.#.....#...#.#.....#.#.#...#...#...#.............#.#.#
###.#.###.#.#.###.#######.#.#########.#.#.#####.#.#.#####.###.###############.#.#
#...#.#...#.#.....#.....#...#.........#...#...#.#.#.#.......#.......#.......#.#.#
#.###.#####.###.###.###.#####.###########.#.#.#.#.#.#.#####.#######.#######.#.#.#
#...#.....#...#.....#.#.....#.#...#...#...#.#...#.#.#.....#.......#...#.....#.#.#
###.#####.###.###.###.#####.#.#.#.#.#.#.###.#####.#.#####.###########.#.#####.###
#.......#.....#...#.#.#.....#.#.#...#.#.....#...#.#.#...#...#.....#.....#...#...#
#####.#######.#.###.#.###.###.#.#####.#######.###.#.#.#.###.#.#.#.###.#####.###.#
#...#...........#...#.....#.........#...#...#.....#.#.#.....#.#.#.....#.......#.#
#.#########.#.###.#######.#.#######.###.#.#.#.#####.#.#######.#.###########.#.#.#
#...........#...........#...#.......#...#.#...#.....#.........#.............#....
#################################################################################